000000000000
111111111111
000000000000
000000000000
010010010010
000000000000
102000000201
113333333311
100000000001
000000000000
121212121212
212121212121
000000000000
000000000000
000000000000
000000000000
000000000000
000000000000
000000000000