000000000000
000000000000
000000000000
000000000000
000000000000
000000000000
000000000000
111111111111
111111111111
333333333333
111111111111
111111111111
111111111111
000000000000
000000000000
000000000000
000000000000
000000000000
000000000000