111111111111
111111111111
320001100023
200110011002
011000000110
110002200011
110023320011
110002200011
011000000110
000110011000
000001100000
000001100000
111312213111
111312213111
000000000000
000000000000
000000000000
000000000000
000000000000