000000000000
000000000000
121212121212
000000000000
000110011000
001111111100
011221122110
112321123211
123332233321
100000000001
100000000001
010000000010
001323232100
000100001000
011010010110
100101101001
000000000000
000000000000
000000000000