000000000000
000000000000
000000000000
000000000000
000003300000
000330033000
033000000330
022001100220
033000000330
000330033000
000003300000
000000000000
000000000000
000000000000
111111111111
111111111111
000000000000
000000000000
000000000000