111111111111
111111111111
000001100000
000110011000
011000000110
110002200011
110023320011
110002200011
011000000110
000110011000
000001100000
000000000000
111111111111
111111111111
000000000000
000000000000
000000000000
000000000000
000000000000